#E#######################
# # ###                 #
# #  #   ###########    #
#       ############# ###
####### #               #
S       # ######### #   #
#       #           #   #
#####################   #
#        ###       #    #
#      #      ####      #
#########################